PPPPPPPPPPPPPPPPPPPPPPPPPPPP
P  P                       P
P  PPPPPP                  P
P  P     P    P            P
P  P      P   P            P
P  P       P  P            P
P  P         PP    PPPPPPPPP
P  P        P P            P
P  P       P  P            P
P  P      P   PPPPPP       P
P  P     P    PP           P
P  P PP       PPP      PPPPP
P  PPPPP      PPPP    PPPPPP
P       P     PPPPP  PPPPPPP
P        PP   P            P
P             P            P
P             P         PPPP
P             P         PPPP
PPPPPPPPPPPPPPPE           P
PPPPPPPPPPPPPPPPPPPPPPPPPPPP